00000000000000000000000000000000000000000000000000000000000000000000000000000000
00000000000000000000000000000000000022222222220000000000000000000000000000000000
00000222222220000000000000000000000021111111120000000000000000000000000000000000
00000211111120000000000000000000000021111111120000000000000000000000000000000000
00000211111120000000000000000000000021111111120000000000000000000000000000000000
00000211111120000000000000000000000021111111120000000000000000000000000000000000
00000211111120000000000000000000000021111111120000000000000000000000000000000000
00000211111122222220000000000000000021111111120000000000000000000000000000000000
00000211111131111120000000000000000021111111120000000000000000000000000000000000
00000211111122222120000000000000000021111111120000000000000000000000000000000000
00000211111120002120000000000000000021111111120000000000000000000000000000000000
00000211111120002120000000000000000021111111120000000000000000000000000000000000
00000211111120002120000000000000000021111111120000000000000000000000000000000000
00000211111120002120000000000000000021111111120000000000000000000000000000000000
00000222222220002120000000000000000022223222220000000000000000000000000000000000
00000000000000002120000000000000000000021200000000000000000000000000000000000000
00000000000000002120000000000000000022221222000000000000000000000000000000000000
00000000000000002120000000000000000021111112000000000000000000000000000000000000
00000000000000002120000000000000000021111112222222222000000000000000000000000000
00000000000000002120000000000000000021111112211111112000000000000000000000000000
00000000000000002120000000000000000021111112211111112000000000000000000000000000
00000000000000002120000000000000000021111112211111112000000000000000000000000000
00000000000000002120000000000000000022223222211111112000000000000000000000000000
00000000000002222122200000000000000000021222211111112222222222222222222222200000
00000000000002111111200000000000000000021161311111113111111111116111111111200000
00000000000002111111200000000000000000021222211111112222222222222222222221200000
00000000000002111111200000000000000000021200211111112000000000000000000021200000
00000000000002111111200000000000000000021200211111112000000000000000002221522000
00000000000002111111200000000000000000021200211111112000000000000000002111112000
00000000000002111111200000000000000000021200211111112000000000000000002111112000
00000000000002111111200000000000000000021200222222222000000000000000002111112000
00000000000002111111200000000000000000021200000000000000000000000000002111112000
00000000000002111111200000000000000000021200000000000000000000000000002111112000
00000000000002111111200000000022222222021200000000000000000000000000002111112000
00000000000002111111200000000021111112021200000000000000000000000000002111112000
00000000000002222223200000000021111112021200000000000000000000000000002111112000
00000000000000000021200000000021111112021200000000000000000000000000002222222000
00000000000000000021200000000021111112221200000000000000000000000000000000000000
00000000000000000021200000000021111114111200000000000000000000000000000000000000
00000000000000000021200000000021111112222200000000000000000000000000000000000000
00000000000000000021200000000021111112000000000000000000000000000000000000000000
00000000000000000021200000000021111112000000000000000000000000000000000000000000
00000000000000000021200000000022223222000000000000000000000000000000000000000000
00000000000000000021200000000000021200000000000000000000000000000000000000000000
00000000000000222221222200000000021200000000000000000000000000000000000000000000
00000000000000211111111200000000021200000000000000000000000000000000000000000000
00000000000000211111111200000000021200000000000000000000000000000000000000000000
00000000000000211111111222222222221200000000000000000000000000000000000000000000
00000000000000211111111311111111111200000000000000000000000000000000000000000000
00000000000000211111111222222222222200000000000000000000000000000000000000000000
00000000000000211111111200000000000000000000000000000000000000000000000000000000
00000000000000211111111200000000000000000000000000000000000000000000000000000000
00000000000000222222222200000000000000000000000000000000000000000000000000000000
00000000000000000000000000000000000000000000000000000000000000000000000000000000
00000000000000000000000000000000000000000000000000000000000000000000000000000000
00000000000000000000000000000000000000000000000000000000000000000000000000000000
00000000000000000000000000000000000000000000000000000000000000000000000000000000
00000000000000000000000000000000000000000000000000000000000000000000000000000000
00000000000000000000000000000000000000000000000000000000000000000000000000000000
00000000000000000000000000000000000000000000000000000000000000000000000000000000
