00000000000000000000
00000000000000000000
00010000000000000000
00011000000000000000
00001100000000000000
00000111111100000000
00000111111100000000
00000111111100000000
00000111111100100000
00000111111100000000
00000111111100000000
00000000010000000000
00000000011000000000
00000000001100000000
00000000000100000000
00000000000000000000
00000000000000000000
00000000000000000000
00000000000000000000
00000000000000000000
