222222222222222222222222222222222222222222222222222222222222
222222222222222222222222222222222222222222222222222222222222
222222222222222222222222222222222222222222222222222222222222
222222222222222222222222222222222222222222222222222222222222
222222222222222222222222222222222222222222222222222222222222
222222222222222222222222222222222222222222222222222222222222
222222222222222222222222222222222222222222222222222222222222
222222222222222222222222222222222222222222222222222222222222
222222222222222222222222222222222222222222222222222222222222
222222222222222222222222222222222222222222222222222222222222
222222222222222222222222222222222222222222222222222222222222
222222222222222222222222222222222222222222222222222222222222
222222222222222222222222222222222222222222222222222222222222
222222222222222222222222222222222222222222222222222222222222
222222222222222222222222222222222222222222222222222222222222
222222222222222222222222222222222222222222222222222222222222
222222222222222222222222222222222222222222222222222222222222
222222222222222222222222222222222222222222222222222222222222
222222222222111111111111111111111222222222222222222222222222
222222222222100000000001000000001222222222222222222222222222
222222222222100000000001000000001222222222222222222222222222
222222222222100000000001000000001222222222222222222222222222
222222222222100000000003000000001222222222222222222222222222
222222222222100000000001000000001222221112222222222222222222
222222222222100000000001000000001222211011222222222222222222
221111111111111113111111000000001222210001222222222222222222
221000000000010000001111111131111111111411111111111222222222
221000000000010000001110000000000100000000010000001222222222
221000000000010000001110000000000100000000010000001222222222
221000000000030000001110000000000100000000010000001222222222
221000000000010000001110000000000100000000010000001111111111
221000000000010000000000000000000100000000010000001110000001
221000000000010000001110000000000100000000030000001110000001
221111111111111111111110000000000100000000010000001110000001
222222222222222222222210000000000300000000010000001110000001
222222222222222222222210000000000100000000010000001110000001
222222222222222222222211111111111111111111110000001110000001
222222222222222222222222222222222221111111111113111111110001
222222222222222222222222222222222221000000100000000010000001
222222222222222222222222222222222221000000100000000010000001
222222222222222222222222222222222221000000100000000010000001
222222222222222222222222222222222221000000100000000010000001
222222222222222222222222222222111111000000100000000010000001
222222222222222222222222222222100001000000000000000000000001
222222222222222222222222222222100003000000000000000000000001
222222222222222222222222222222100001000000000000000000000001
222222222222222222222222222222111111000000100000000010000001
222222222222222222222222222222222221000000100000000010000001
222222222222222222222222222222222221111111111113111111111411
222222222222222222222222222222222222222222100000000012210001
222222222222222222222222222222222222222222100000000012211111
222222222222222222222222222222222222222222100000000012222222
222222222222222222222222222222222222222222100000000012222222
222222222222222222222222222222222222222222100000000012222222
222222222222222222222222222222222222222222100000000012222222
222222222222222222222222222222222222222222111111111112222222
222222222222222222222222222222222222222222222222222222222222
222222222222222222222222222222222222222222222222222222222222
222222222222222222222222222222222222222222222222222222222222
222222222222222222222222222222222222222222222222222222222222
