000000000000000000000000000000000000000000000000000000000000
000000000000000000000000000000000000000000000000000000000000
000000000000000000000000000000000000000000000000000000000000
000000000000000000000000000000000000000000000000000000000000
000000000000000000000000000000000000000000000000000000000000
000000000000000000000000000000000000000000000000000000000000
000000000000000000000000000000000000000000000000000000000000
000000000000000000000000000000000000000000000000000000000000
000000000000000000000000000000000000000000000000000000000000
000000000000000000000000000000000000000000000000000000000000
000000000000000000000000000000000000000000000000000000000000
000000000000000000000000000000000000000000000000000000000000
000000000000000000000000000000000000000000000000000000000000
000000000000000000000000000000000000000000000000000000000000
000000000000000000000000000000000000000000000000000000000000
000000000000000000000000000000000000000000000000000000000000
000000000000000000000000000000000000000000000000000000000000
000000000000000000000000000000000000000000000000000000000000
000000000000222222222222222222222000000000000000000000000000
000000000000211111111112111111112000000000000000000000000000
000000000000211111111112111111112000000000000000000000000000
000000000000211111111112111111112000000000000000000000000000
000000000000211111111113111111112000000000000000000000000000
000000000000211111111112111111112000002220000000000000000000
000000000000211111111112111111112000022122000000000000000000
002222222222222223222222111111112000021112000000000000000000
002111111111121111112222222242222222222522222222222000000000
002111111111121111112226111111111211111111121111112000000000
002111111111121111112221111111111211111111121111112000000000
002111111111131111112221111111111211111111121111112000000000
002111111111121111112221111111111211111111121111112222222222
002111111111121111111111111111111211111111121111112221111112
002111111111121111112221111111111211111111131111112221111112
002222222222222222222221111111111211111111121111112221111112
000000000000000000000021111111111311111111121111112221111112
000000000000000000000021111111111211111111121111112221111112
000000000000000000000022222222222222222222221111112221111112
000000000000000000000000000000000002222222222223222222221112
000000000000000000000000000000000002111111211111111121111112
000000000000000000000000000000000002111111211111111121111112
000000000000000000000000000000000002111111211111111121111112
000000000000000000000000000000000002111111211111111121111112
000000000000000000000000000000222222111111211111111121111112
000000000000000000000000000000211112111111111111111111111112
000000000000000000000000000000211113111111111111111111111112
000000000000000000000000000000211112111111111111111111111112
000000000000000000000000000000222222111111211111111121111112
000000000000000000000000000000000002111111211111111121111112
000000000000000000000000000000000002222222222223222222222522
000000000000000000000000000000000000000000211111111120021112
000000000000000000000000000000000000000000211111111120022222
000000000000000000000000000000000000000000211111111120000000
000000000000000000000000000000000000000000211111111120000000
000000000000000000000000000000000000000000211111111120000000
000000000000000000000000000000000000000000211111111120000000
000000000000000000000000000000000000000000222222222220000000
000000000000000000000000000000000000000000000000000000000000
000000000000000000000000000000000000000000000000000000000000
000000000000000000000000000000000000000000000000000000000000
000000000000000000000000000000000000000000000000000000000000
