22242222222222222222
21111111211111121112
21111111211111131112
21111111211111121112
21111111211111121112
21111111211111121112
22222232211111121112
21111111211111122322
21111111211111121112
21111111211111121112
21111111223222221112
21111111211111121112
22322222211111121112
21111111211111122322
21111111211111121112
21111111111111151112
21111111111111121112
21111111211111121112
21111111211111121112
22222222222222222222
